-0.01
-10000
500
1
15 4 500
#############################
#OOOOO        OOOOOO     OOO#
#                           #
#                           #
#H             G           O#
#                           #
#                           #
#OOOOO        OOOOOO     OOO#
#############################